KOA = "countries/Kingdom Akorn.txt"
KUN = "countries/Kingdom of Kungaria.txt"
RCR = "countries/Soviet Retenia.txt"
SWA = "countries/Swartzland.txt"
PSR = "countries/Psarska.txt"
EGG = "countries/Eggman Empire.txt"
NEA = "countries/New Avalon.txt"
SVT = "countries/Svyetlales.txt"
INF = "countries/Jackal Land.txt"
NOR = "countries/Northamer Republic.txt"
SOT = "countries/Southern Baronies.txt" 
GDK = "countries/Great Desert Kingdom.txt"
PIR = "countries/Pirenia.txt"
UMK = "countries/Umkiria.txt"
NRD = "countries/Northamer DEL.txt"
CRI = "countries/Criardie.txt"
CNS = "countries/Consulia.txt"
STD = "countries/Studiopolis.txt"
GDD = "countries/Great Desert DEL.txt"
HIB = "countries/Hiboulia Commune.txt"
OLP = "countries/Olppaon.txt"
AVI = "countries/Republic of Avisla.txt"
NWC = "countries/Northwestern Committee.txt"
WEC = "countries/Western Committee.txt"
BRC = "countries/Brastropolis Committee.txt"
SOC = "countries/Southern Committee.txt"
NOC = "countries/Northern Committee.txt"
SIC = "countries/Siverian Committee.txt"
FEC = "countries/Far Eastern Committee.txt"
LTG = "countries/Latigalia.txt"
TYY = "countries/Tyynimia.txt"
WOL = "countries/Wolfpack Nation.txt"
MIS = "countries/Pais Misterioso.txt"
BAN = "countries/Bananas Republic.txt"
LAO = "countries/Lao-Dzun.txt"
RIO = "countries/Rio Escuro.txt"
GKR = "countries/Great Kordovian Republic.txt"
EST = "countries/Estado-de-Lagarto.txt"
JUN = "countries/Jungleo-Ido.txt"
SOU = "countries/Soumerca DEL.txt"
ZIN = "countries/Zincumia.txt"
LAM = "countries/Llama Empire.txt"
PAT = "countries/Patu Tribe.txt"
PIC = "countries/Pirate Confederation.txt"
FAN = "countries/Fanto Domingo.txt"
FIR = "countries/Fire Islands.txt"
ANG = "countries/Angel Island.txt"
UFA = "countries/United Federation.txt"
LEO = "countries/Kingdom of Leonus.txt"
HUR = "countries/Huranjan-Karab.txt"
MID = "countries/Middleland Governor-generality.txt"
BHA = "countries/Bharatsha.txt"
ARC = "countries/Arctic Federation.txt"
MER = "countries/Mercia.txt"
CHE = "countries/Cherniwschina.txt"
TUK = "countries/Tukmania.txt"
DOW = "countries/Downunda.txt"
HOL = "countries/Holoska.txt"
JAT = "countries/Jatzu Clique.txt"
KUE = "countries/Kun Empire.txt"
IRO = "countries/Iron Dominion.txt"
SHI = "countries/Shinobi Clique.txt"
REI = "countries/Reitzu Clique.txt"
GOS = "countries/Gossamer Clique.txt"
FRE = "countries/Free People.txt"
NIK = "countries/Nikko.txt"
KAE = "countries/Kazu Empire.txt"
GEG = "countries/Gegam Republic.txt"
TRA = "countries/Transashia.txt"
KUA = "countries/Kuasa Kingdom.txt"
KRO = "countries/Krolang.txt"
PSG = "countries/PSGR.txt"
OLP = "countries/OLP.txt"
UWM = "countries/Northamer Commune.txt"